# This data was created with GBCMapEditor.
# https://github.com/emutyworks/GBCMapEditor/wiki
# [Create] Tue Apr 01 2025 04:18:38 GMT+0900 (GMT+09:00)
# [FileName] map_editor
#
# [BGPalette]
	dw 576
	dw 12684
	dw 32767
	dw 31

	dw 576
	dw 12684
	dw 1023
	dw 32767

	dw 10565
	dw 32234
	dw 32767
	dw 0

	dw 266
	dw 500
	dw 10565
	dw 0

	dw 0
	dw 0
	dw 0
	dw 0

	dw 0
	dw 0
	dw 0
	dw 0

	dw 0
	dw 0
	dw 0
	dw 0

	dw 0
	dw 0
	dw 0
	dw 0

# [TilePalette]
	db 0,0,2,2,2,2,1,0
	db 0,0,0,0,0,0,0,0
	db 0,0,0,0,0,0,0,0
	db 0,0,0,0,0,1,1,1
	db 1,3,2,2,2,2,2,2
	db 3,3,0,0,0,1,1,1
	db 1,1,1,1,1,0,0,0
	db 0,0,0,0,0,0,0,0
	db 2,2,2,2,2,2,0,0
	db 0,0,0,0,0,0,0,0
	db 0,0,0,0,0,0,0,0
	db 0,0,0,0,0,0,0,0
	db 0,0,0,0,0,0,0,0
	db 0,0,0,0,0,0,0,0
	db 0,0,0,0,0,0,0,0
	db 0,0,0,0,0,0,0,0
	db 0,0,0,0,0,0,0,0
	db 0,0,0,0,0,0,0,0
	db 0,0,0,0,0,0,0,0
	db 0,0,0,0,0,0,0,0
	db 0,0,0,0,0,0,0,0
	db 0,0,0,0,0,0,0,0
	db 0,0,0,0,0,0,0,0
	db 0,0,0,0,0,0,0,0
	db 0,0,0,0,0,0,0,0
	db 0,0,0,0,0,0,0,0
	db 0,0,0,0,0,0,0,0
	db 0,0,0,0,0,0,0,0
	db 0,0,0,0,0,0,0,0
	db 0,0,0,0,0,0,0,0
	db 0,0,0,0,0,0,0,0
	db 0,0,0,0,0,0,0,0

# [MapTbl]
# [MapSize] 32x32
# [MapScreens] 1
# [ShowGrid] true
	db $40,$41,$42,$43,$44,$45,$02,$02,$02,$02,$02,$02,$02,$02,$02,$02,$02,$02,$02,$02,$02,$02,$02,$02,$02,$02,$02,$02,$02,$02,$02,$02
	db $02,$02,$02,$02,$02,$02,$02,$02,$02,$02,$02,$02,$02,$02,$02,$02,$02,$02,$02,$02,$02,$02,$02,$02,$02,$02,$02,$02,$02,$02,$02,$02
	db $02,$02,$02,$02,$02,$02,$02,$02,$02,$02,$02,$02,$02,$02,$02,$02,$02,$02,$02,$02,$02,$02,$02,$02,$02,$02,$02,$02,$02,$02,$02,$02
	db $02,$02,$02,$02,$02,$02,$02,$02,$02,$02,$02,$02,$02,$02,$02,$02,$02,$02,$02,$02,$02,$02,$02,$02,$02,$02,$02,$02,$02,$02,$02,$02
	db $02,$02,$02,$02,$02,$02,$02,$02,$02,$02,$02,$02,$02,$02,$02,$02,$02,$02,$02,$02,$02,$02,$02,$02,$02,$02,$02,$02,$02,$02,$02,$02
	db $02,$02,$02,$02,$02,$02,$02,$02,$02,$02,$02,$02,$02,$02,$02,$02,$02,$02,$02,$02,$02,$02,$02,$02,$02,$02,$02,$02,$02,$02,$02,$02
	db $02,$02,$02,$02,$02,$02,$02,$02,$02,$02,$02,$02,$02,$02,$02,$02,$02,$02,$02,$02,$02,$02,$02,$02,$02,$02,$02,$02,$02,$02,$02,$02
	db $02,$02,$02,$02,$02,$02,$02,$02,$02,$02,$02,$24,$25,$25,$26,$02,$02,$02,$02,$02,$02,$02,$02,$02,$02,$02,$02,$02,$02,$02,$02,$02
	db $23,$23,$22,$22,$23,$23,$23,$22,$22,$23,$23,$22,$22,$23,$23,$22,$22,$23,$23,$23,$22,$22,$23,$23,$22,$22,$23,$23,$22,$22,$23,$23
	db $29,$28,$29,$29,$28,$29,$28,$28,$29,$29,$28,$29,$28,$29,$28,$28,$29,$28,$29,$28,$29,$28,$29,$28,$28,$29,$29,$28,$28,$29,$28,$29
	db $00,$00,$00,$00,$00,$00,$00,$00,$14,$20,$20,$14,$00,$00,$00,$00,$00,$00,$00,$00,$00,$00,$00,$00,$00,$00,$00,$00,$00,$00,$00,$00
	db $00,$00,$00,$00,$00,$00,$12,$13,$1C,$1F,$1F,$1C,$13,$12,$00,$00,$00,$00,$00,$00,$00,$00,$00,$00,$00,$00,$00,$00,$00,$00,$00,$00
	db $00,$00,$00,$00,$00,$10,$11,$15,$01,$1E,$1E,$01,$15,$11,$10,$00,$00,$00,$00,$00,$00,$00,$00,$00,$00,$00,$00,$00,$00,$00,$00,$00
	db $00,$00,$00,$00,$0E,$0F,$16,$01,$01,$1E,$1E,$01,$01,$16,$0F,$0E,$00,$00,$00,$00,$00,$00,$00,$00,$00,$00,$00,$00,$00,$00,$00,$00
	db $00,$00,$00,$0C,$0D,$17,$01,$01,$01,$1E,$1E,$01,$01,$01,$17,$0D,$0C,$00,$00,$00,$00,$00,$00,$00,$00,$00,$00,$00,$00,$00,$00,$00
	db $00,$00,$0A,$0B,$18,$01,$01,$01,$01,$1D,$1D,$01,$01,$01,$01,$18,$0B,$0A,$00,$00,$00,$00,$00,$00,$00,$00,$00,$00,$00,$00,$00,$00
	db $00,$09,$08,$19,$01,$01,$01,$01,$01,$1D,$1D,$01,$01,$01,$01,$01,$19,$08,$09,$00,$00,$00,$00,$00,$00,$00,$00,$00,$00,$00,$00,$00
	db $07,$08,$1B,$1A,$01,$01,$01,$01,$01,$1D,$1D,$01,$01,$01,$01,$01,$1A,$1B,$08,$07,$00,$00,$00,$00,$00,$00,$00,$00,$00,$00,$00,$00
	db $00,$00,$00,$00,$00,$00,$00,$00,$14,$1C,$1C,$14,$00,$00,$00,$00,$00,$00,$00,$00,$00,$00,$00,$00,$00,$00,$00,$00,$00,$00,$00,$00
	db $00,$00,$00,$00,$00,$00,$12,$13,$1C,$01,$01,$1C,$13,$12,$00,$00,$00,$00,$00,$00,$00,$00,$00,$00,$00,$00,$00,$00,$00,$00,$00,$00
	db $00,$00,$00,$00,$00,$10,$11,$15,$01,$01,$01,$01,$15,$11,$10,$00,$00,$00,$00,$00,$00,$00,$00,$00,$00,$00,$00,$00,$00,$00,$00,$00
	db $00,$00,$00,$00,$0E,$0F,$16,$01,$01,$01,$01,$01,$01,$16,$0F,$0E,$00,$00,$00,$00,$00,$00,$00,$00,$00,$00,$00,$00,$00,$00,$00,$00
	db $00,$00,$00,$0C,$0D,$17,$01,$01,$01,$01,$01,$01,$01,$01,$17,$0D,$0C,$00,$00,$00,$00,$00,$00,$00,$00,$00,$00,$00,$00,$00,$00,$00
	db $00,$00,$0A,$0B,$18,$01,$01,$01,$01,$01,$01,$01,$01,$01,$01,$18,$0B,$0A,$00,$00,$00,$00,$00,$00,$00,$00,$00,$00,$00,$00,$00,$00
	db $00,$09,$08,$19,$01,$01,$01,$01,$01,$01,$01,$01,$01,$01,$01,$01,$19,$08,$09,$00,$00,$00,$00,$00,$00,$00,$00,$00,$00,$00,$00,$00
	db $07,$08,$1B,$1A,$01,$01,$01,$01,$01,$01,$01,$01,$01,$01,$01,$01,$1A,$1B,$08,$07,$00,$00,$00,$00,$00,$00,$00,$00,$00,$00,$00,$00
	db $00,$00,$00,$00,$00,$00,$00,$00,$00,$00,$00,$00,$00,$00,$00,$00,$00,$00,$00,$00,$00,$00,$00,$00,$00,$00,$00,$00,$00,$00,$00,$00
	db $00,$00,$00,$00,$00,$00,$00,$00,$00,$00,$00,$00,$00,$00,$00,$00,$00,$00,$00,$00,$00,$00,$00,$00,$00,$00,$00,$00,$00,$00,$00,$00
	db $00,$00,$00,$00,$00,$00,$00,$00,$00,$00,$00,$00,$00,$00,$00,$00,$00,$00,$00,$00,$00,$00,$00,$00,$00,$00,$00,$00,$00,$00,$00,$00
	db $00,$00,$00,$00,$00,$00,$00,$00,$00,$00,$00,$00,$00,$00,$00,$00,$00,$00,$00,$00,$00,$00,$00,$00,$00,$00,$00,$00,$00,$00,$00,$00
	db $00,$00,$00,$00,$00,$00,$00,$00,$00,$00,$00,$00,$00,$00,$00,$00,$00,$00,$00,$00,$00,$00,$00,$00,$00,$00,$00,$00,$00,$00,$00,$00
	db $00,$00,$00,$00,$00,$00,$00,$00,$00,$00,$00,$00,$00,$00,$00,$00,$00,$00,$00,$00,$00,$00,$00,$00,$00,$00,$00,$00,$00,$00,$00,$00

# [AttributesTbl]
	db $02,$02,$02,$02,$02,$02,$02,$02,$02,$02,$02,$02,$02,$02,$02,$02,$02,$02,$02,$02,$02,$02,$02,$02,$02,$02,$02,$02,$02,$02,$02,$02
	db $02,$02,$02,$02,$02,$02,$02,$02,$02,$02,$02,$02,$02,$02,$02,$02,$02,$02,$02,$02,$02,$02,$02,$02,$02,$02,$02,$02,$02,$02,$02,$02
	db $02,$02,$02,$02,$02,$02,$02,$02,$02,$02,$02,$02,$02,$02,$02,$02,$02,$02,$02,$02,$02,$02,$02,$02,$02,$02,$02,$02,$02,$02,$02,$02
	db $02,$02,$02,$02,$02,$02,$02,$02,$02,$02,$02,$02,$02,$02,$02,$02,$02,$02,$02,$02,$02,$02,$02,$02,$02,$02,$02,$02,$02,$02,$02,$02
	db $02,$02,$02,$02,$02,$02,$02,$02,$02,$02,$02,$02,$02,$02,$02,$02,$02,$02,$02,$02,$02,$02,$02,$02,$02,$02,$02,$02,$02,$02,$02,$02
	db $02,$02,$02,$02,$02,$02,$02,$02,$02,$02,$02,$02,$02,$02,$02,$02,$02,$02,$02,$02,$02,$02,$02,$02,$02,$02,$02,$02,$02,$02,$02,$02
	db $02,$02,$02,$02,$02,$02,$02,$02,$02,$02,$02,$02,$02,$02,$02,$02,$02,$02,$02,$02,$02,$02,$02,$02,$02,$02,$02,$02,$02,$02,$02,$02
	db $02,$02,$02,$02,$02,$02,$02,$02,$02,$02,$02,$02,$02,$02,$22,$02,$02,$02,$02,$02,$02,$02,$02,$02,$02,$02,$02,$02,$02,$02,$02,$02
	db $02,$02,$02,$22,$02,$02,$02,$02,$22,$02,$02,$02,$22,$02,$02,$02,$22,$02,$02,$02,$22,$02,$02,$02,$02,$22,$02,$02,$02,$22,$02,$02
	db $03,$03,$03,$03,$03,$23,$03,$03,$03,$03,$03,$03,$03,$23,$03,$03,$23,$03,$03,$23,$03,$03,$03,$23,$03,$03,$03,$03,$03,$03,$03,$03
	db $00,$00,$00,$00,$00,$00,$00,$00,$00,$01,$21,$20,$00,$00,$00,$00,$00,$00,$00,$00,$00,$00,$00,$00,$00,$00,$00,$00,$00,$00,$00,$00
	db $00,$00,$00,$00,$00,$00,$00,$00,$00,$01,$21,$20,$20,$20,$00,$00,$00,$00,$00,$00,$00,$00,$00,$00,$00,$00,$00,$00,$00,$00,$00,$00
	db $00,$00,$00,$00,$00,$00,$00,$00,$00,$01,$21,$00,$20,$20,$20,$00,$00,$00,$00,$00,$00,$00,$00,$00,$00,$00,$00,$00,$00,$00,$00,$00
	db $00,$00,$00,$00,$00,$00,$00,$00,$00,$01,$21,$00,$00,$20,$20,$20,$00,$00,$00,$00,$00,$00,$00,$00,$00,$00,$00,$00,$00,$00,$00,$00
	db $00,$00,$00,$00,$00,$00,$00,$00,$00,$01,$21,$00,$00,$00,$20,$20,$20,$00,$00,$00,$00,$00,$00,$00,$00,$00,$00,$00,$00,$00,$00,$00
	db $00,$00,$00,$00,$00,$00,$00,$00,$00,$01,$21,$00,$00,$00,$00,$20,$20,$20,$00,$00,$00,$00,$00,$00,$00,$00,$00,$00,$00,$00,$00,$00
	db $00,$00,$00,$00,$00,$00,$00,$00,$00,$01,$21,$00,$00,$00,$00,$00,$20,$20,$20,$00,$00,$00,$00,$00,$00,$00,$00,$00,$00,$00,$00,$00
	db $00,$00,$00,$00,$00,$00,$00,$00,$00,$01,$21,$00,$00,$00,$00,$00,$21,$20,$20,$20,$00,$00,$00,$00,$00,$00,$00,$00,$00,$00,$00,$00
	db $00,$00,$00,$00,$00,$00,$00,$00,$01,$01,$21,$21,$00,$00,$00,$00,$00,$00,$00,$00,$00,$00,$00,$00,$00,$00,$00,$00,$00,$00,$00,$00
	db $00,$00,$00,$00,$00,$00,$01,$01,$01,$00,$00,$21,$21,$21,$00,$00,$00,$00,$00,$00,$00,$00,$00,$00,$00,$00,$00,$00,$00,$00,$00,$00
	db $00,$00,$00,$00,$00,$01,$01,$01,$00,$00,$00,$00,$21,$21,$21,$00,$00,$00,$00,$00,$00,$00,$00,$00,$00,$00,$00,$00,$00,$00,$00,$00
	db $00,$00,$00,$00,$01,$01,$01,$00,$00,$00,$00,$00,$00,$21,$21,$21,$00,$00,$00,$00,$00,$00,$00,$00,$00,$00,$00,$00,$00,$00,$00,$00
	db $00,$00,$00,$01,$01,$01,$00,$00,$00,$00,$00,$00,$00,$00,$21,$21,$21,$00,$00,$00,$00,$00,$00,$00,$00,$00,$00,$00,$00,$00,$00,$00
	db $00,$00,$01,$01,$01,$00,$00,$00,$00,$00,$00,$00,$00,$00,$00,$21,$21,$21,$00,$00,$00,$00,$00,$00,$00,$00,$00,$00,$00,$00,$00,$00
	db $00,$01,$01,$01,$00,$00,$00,$00,$00,$00,$00,$00,$00,$00,$00,$00,$21,$21,$21,$00,$00,$00,$00,$00,$00,$00,$00,$00,$00,$00,$00,$00
	db $01,$01,$01,$01,$00,$00,$00,$00,$00,$00,$00,$00,$00,$00,$00,$00,$21,$21,$21,$21,$00,$00,$00,$00,$00,$00,$00,$00,$00,$00,$00,$00
	db $00,$00,$00,$00,$00,$00,$00,$00,$00,$00,$00,$00,$00,$00,$00,$00,$00,$00,$00,$00,$00,$00,$00,$00,$00,$00,$00,$00,$00,$00,$00,$00
	db $00,$00,$00,$00,$00,$00,$00,$00,$00,$00,$00,$00,$00,$00,$00,$00,$00,$00,$00,$00,$00,$00,$00,$00,$00,$00,$00,$00,$00,$00,$00,$00
	db $00,$00,$00,$00,$00,$00,$00,$00,$00,$00,$00,$00,$00,$00,$00,$00,$00,$00,$00,$00,$00,$00,$00,$00,$00,$00,$00,$00,$00,$00,$00,$00
	db $00,$00,$00,$00,$00,$00,$00,$00,$00,$00,$00,$00,$00,$00,$00,$00,$00,$00,$00,$00,$00,$00,$00,$00,$00,$00,$00,$00,$00,$00,$00,$00
	db $00,$00,$00,$00,$00,$00,$00,$00,$00,$00,$00,$00,$00,$00,$00,$00,$00,$00,$00,$00,$00,$00,$00,$00,$00,$00,$00,$00,$00,$00,$00,$00
	db $00,$00,$00,$00,$00,$00,$00,$00,$00,$00,$00,$00,$00,$00,$00,$00,$00,$00,$00,$00,$00,$00,$00,$00,$00,$00,$00,$00,$00,$00,$00,$00
